----S--[]--------X----------------------------------------------------X------<>---------------------------------------------------------------X------------X---X--------------------------X------------S--
-------[]--------X-------------------X--------------------------------X------[]-S--Q------------------------------------------E-------------X-X------------X---XX-------------------------X----S----------
------XXXX-------X-------------------X--X---------------X-------------X------[]-----------------------------------?-X-----------------------X-XX-----------X---XX-----------S-------------X----------Q----
------XXXX--S----X-X---X-------------X-XX---------------X-------------X---X--[]-------------------------------X-----X-------------------S---X-XX-----------X---XX-------------------------X---------------
------XXXX------XXXX---X-----X-------X-XX----X---S------X-------------X---X--[]-------------------------------X-----X---<>------------------X-XX----------XX---XX--------X------X---------X---------------
----X-XXXX------XXXX---X-----X-------X-XX----X----------X-------------X---X--[]---------------------------X---XX----X---[]------------------X-XX-X----S---XX---XX-------XX------X---------X---------------
----X-XXXX-X-X-XXXXX---X-----X-------X-XX----X--X-------X-------------X---X--[]-<>------------------X-----X---XX---XX---[]----------X-------X-XX-X--S---X-XX---XXX------XX------X---------X---------------
----X-XXXX-X-X-XXXXX---XX----X-------X-XX----X--X-------X----S--------X---X--[]-[]-------X----------X-XX--X---XX---XX---[]----------X-------X-XX-X------X-XX---XXX------XXX-----X--------XX---------------
----X-XXXX-X-X-XXXXX---XX---XX-------XXXX---XX--X-------X-------------X---X--[]-[]-------X---------XX-XX--X---XX---XX---[]----------X-------X-XX-X------X-XX---XXX------XXX--E--X--------XX---------------
----X-XXXX-X-X-XXXXX---XX---XX-------XXXX---XX--X-------X-------------X---X--[]-[]-X-----X---------XX-XX--X---XX---XX---[]--S--X---XX-------X-XX-X------X-XX---XXX------XXX----XX--------XX-E-------------
---XX-XXXX-X-X-XXXXX-XXXX-Q-XXX------XXXX---XX--X-X-----X-------------X---X--[]-[]-X-----X---------XX-XX--X---XX---XX---[]-----X---XX-X-----X-XX-X------X-XX---XXX------XXX----XX--------XX------------X--
---XX-XXXX-XXX-XXXXX-XXXX---XXX------XXXX---XX--X-X-----X-------------X---X--[]-[]-X----XX---------XX-XX--X---XX---XX---[]-----X---XX-X-S---XXXX-X--X---X-XX---XXX-X----XXX----XX--------XXX-----------X--
---XX-XXXX-XXX-XXXXXXXXXX---XXX------XXXX---XX--X-X-----XX------------X---X--[]-[]-XX---XX---------XX-XX--X---XX---XXX--[]--Q--X---XX-X-----XXXX-X-XX--XX-XX---XXX-X----XXX----XX--------XXX-----------X--
---XX-XXXXXXXXXXXXXXXXXXX---XXX------XXXX---XX--X-X-X---XX--X---------X---XXXXXXXXXXX---XX------Q--XX-XX--X---XX---XXXXXXXX----X---XX-X-----XXXX-X-XX--XX-XX---XXX-X---XXXX----XX-------XXXX-----------X--
