------------------------------------------[]-------------SS--------------------------------<>-------------------------------------------------------------------------------------------------------------
--E---------------------------------------[]--------------------------X--------------------[]--------------------------Q---------------------------------------------------------------------------------X
-----------X---------------------------X--[]-----------------Q--------XX---------------X---[]--------X-------------------X----------------------------------Q---E--X-S-------------------S------------X--X
-----------X--X-----Q------------------XX-[]--------------------------XX---------------X--XXXX-------X-------------------X-----------------------------------------X---S------------------------------X--X
----<>-----X--XX-----------------S-----XX-[]--------------------------XX---------------X--XXXX---X---X-------------------X-----------------X----X-------X--------X-X-----E----------------------------X--X
----[]-----X--XX--------------X--------XX-[]------X-------------------XX---------------X--XXXX---X---XX-----?------------X-----------------X----X-------X--S-----X-X------------------X-----------E---X--X
----[]-----XX-XX--------------X--Q-----XX-[]-E-X--X-------------------XX---------------X--XXXX---X---XX------------------X---------------S-X----X-----X-X--------X-XX-S--------X------X---Q-----------XXXX
----[]----XXX-XX--X--X--------X--------XX-[]---X--X-X-----------------XX---------------X--XXXX---X---XX-------------S----XX----Q-X---------X----X----XX-X--------XXXX---------XX----X-X--------<>-----XXXX
---XXXX---XXX-XXX-X--X--------X--------XX-[]---X--X-X------Q----X-----XX--X------------X--XXXX---X---XX------------------XX------X--------XX----X----XX-X-------XXXXX---------XX----X-X--------[]-----XXXX
---XXXX---XXX-XXX-X--X--------X------X-XX-[]---X--X-X-----------X-----XX--X------------X--XXXX---X---XX------------------XX------X--------XX----X----XX-X-------XXXXX------X--XX----X-X--------[]--X--XXXX
---XXXX---XXX-XXXXX--X--------X------X-XX-[]---X--X-XX----------XX----XX--X------------X--XXXX---X---XX---------------X--XX------X---E----XX----X-S--XX-X--X----XXXXX------X--XX--Q-XXX--X----XXXXXX--XXXX
---XXXX---XXX-XXXXX--X--------X------X-XX-[]---X--X-XX----------XX----XX--X------<>----X--XXXX---X-S-XX---------------XXXXX-----XX--------XX----X----XX-X--X----XXXXX--E---X--XX----XXX--X----XXXXXX--XXXX
---XXXX---XXX-XXXXX--X--------X------X-XX-[]---X--XXXX----------XX----XX--XX-X---[]----X--XXXX---X---XX---------------XXXXX-----XX--------XX----X-X--XX-X--X----XXXXX------X--XX----XXX--X----XXXXXX--XXXX
---XXXX---XXXXXXXXX--X--------X------X-XXXXXX--X--XXXX-X--------XX----XX--XX-X---[]----XX-XXXX---X---XX---------------XXXXX-----XX--------XX----X-X--XX-X--X----XXXXX------XXXXX----XXX--X----XXXXXX--XXXX
