-----------------<>--------X-------------------------X----------------X-----S-------------XX--[]----------------------XX--------------------------E---X----------------------X----------X-----------------
--S----X---------[]--------X-----------X-------------X-----------X----X------------------XXX--[]----------------------XX-----X-------X----------------X----S-----------------X----------X--------<>-------
-------X---------[]----X---X-----------X-------------X-----------X----X---------------X--XXX--[]----------------------XX-----X-------X----------------X----------------------X----------X--------[]-------
-------X-X-------[]----X-E-X-----------X-----X-------X-----------X----X-----X---------X--XXX--[]-S------X------X------XX-----X--Q----X----------------X----------------------X----------X--Q-----[]-------
-------X-X------XXXX---X---X--------X--X-----X-X-----X-----------X----XX----X---------X--XXX--[]--------X------X-S-X--XX-----X-------X--------------S-X-E-------------S--X---X----------X--------[]-------
-------X-X-----XXXXX---X---XX-------X--X-----X-XX----X------S----X----XX----X---------X--XXX--[]--X-X---X------X---X--XX-----X-------X--S-------------X------X-----------X---X----------X-----Q--[]-------
-------X-X-----XXXXX---X---XX-------X--XX---XX-XX----X---X-------X----XX----X---------X--XXX--[]--X-X---X------X---X--XX-----X-------X----------------X------X-----------X---X----------X---S---XXXX------
---X---X-X-----XXXXX---XX--XX------XX--XX---XXXXX----X---X-------X----XX----X---------X--XXX--[]--X-X---X------X---X--XX-----X--?----X----------------X------X-----------X---X----------X-------XXXX------
---X--XX-X-----XXXXX---XX--XX------XX--XX---XXXXX----X-Q-X-------X--Q-XX----X---X-----X--XXX--[]--X-X---X------XX--X--XX-----X----S--X----------------X-----XX-----------X---X--X-------XXX-----XXXX------
---X--XX-X----XXXXXXX--XX--XX--X---XXX-XX---XXXXX----X---X-------X----XX----X---X---E-X--XXX--[]--X-X---X------XX--X--XX-----X-------X------------S---X-----XX-----------X---X--X-------XXX----XXXXX------
---X--XX-X----XXXXXXX--XX-XXX--X---XXX-XX---XXXXX-Q--X---X-------X---XXX----X---X-----X--XXX--[]--X-X---X-----XXX--X--XX-----X-------X----------------X-----XX-----------X--XX--X-------XXX----XXXXX-SS---
---X--XXXX----XXXXXXX--XX-XXX--X---XXX-XX---XXXXX----X--XX-------X---XXXX---X---XX----X--XXX--[]--X-X---X-----XXXX-X--XX-----X-------X----------------X-X---XX-----------X-XXX--X-------XXX----XXXXX------
--XX-XXXXX----XXXXXXX--XXXXXX--X---XXX-XX---XXXXXX---X--XX------XX---XXXX---X---XX----X--XXX--[]--X-X---X-----XXXX-X--XX-----X-------X----------------X-X---XX--X--------X-XXX--X-------XXX----XXXXX------
--XX-XXXXX----XXXXXXX--XXXXXX--X---XXX-XX---XXXXXX---X--XX------XX---XXXX---X---XX----X--XXXXXXXX-XXX---X-----XXXX-X-XXX--X--X--X----X-------------E--XXX---XX--X--------XXXXX--X-------XXX----XXXXX------
