-S?----S----------------------E-------S---------------------------------------X----------------------------------<>----------X--------------------------E----------E----S----------E----------------------
--------------------X------------------------------------X-------<>-----------XX-----------X-----------------?S--[]--X-------X----?-----X------------------X----------------------------------E-----------
--------------------X------------------------X-----------X----S--[]-------X---XX-------S-Q-X---------------------[]--X-------X----------XX-----X--X--------X----------X--S-----------X--------------------
-----------X--------X------------------------X---X-------X-X-----[]-------X---XX-----------X---------------------[]--X-------X-S--------XX-----X--X------X-X----------X--------------X--------------------
----------XX--------X------------S-----------X---X-------X-X-----[]-------X---XX---------X-X----<>---------------[]--X-------X----------XX-----X--X------X-X---X------X-------------XX-------------XX-----
----------XX----E---X------------------------X---X-------X-X-----[]-------X---XX---------XXX----[]---------------[]--X-------X----------XX-----X--X------X-X---X------X-------------XX-------------XX--X--
----------XX--------X------------------------X---X-------XXX---X-[]-------X---XX---------XXX----[]-------------X-[]--X-------X----------XX-----XX-X------X-X---X------X-------------XX-------------XX--X--
>----S----XX--------X-----?---?--------------X---X-------XXX---XXXXX-----XX---XX---------XXX----[]------X------X-[]--X-------X----------XX-----XX-X------X-X---X------X---Q---------XX-------------XX--X--
]-------X-XX--------X--X--------E----X-------X---X-------XXX---XXXXX-----XX---XX---------XXX---XXXX-----X------X-[]--XX---XX-X----------XX-----XX-X------X-X---X-X---XX-----<>------XX---------X---XX--X--
]-------X-XX--------X--X-------------X-------X---X------XXXX---XXXXX-----XX---XX---------XXX---XXXX-----XX-----X-[]--XX---XX-X----------XX-----XX-X-X----X-X---X-X---XX-----[]------XX-----X---X--XXX--X--
XX------X-XX--------X--X----<>-------X-------X---X----S-XXXX---XXXXX-----XX---XX---------XXX---XXXX-----XX-----X-[]--XX---XX-X----------XX-----XX-X-X----X-X---X-X---XX-----[]------XX-----X---X--XXX--X--
XX----X-X-XX----X---XX-X----[]-------X-------X---X------XXXX---XXXXX-----XX---XXXXX------XXX---XXXX-----XX-----X-[]--XX---XX-X----------XX---S-XX-X-X----X-X---X-X---XX-----[]------XX-----X---X--XXX--X--
XX---XX-X-XX----X---XX-X----[]----S--X-------X---X---E--XXXX---XXXXX-----XX---XXXXX-----XXXXX--XXXXX---XXX-----X-[]--XX---XX-X----------XX-----XX-X-X----X-X---X-X---XXX----[]------XX-----X---XX-XXX--X--
XX---XX-X-XX----X---XXXX---XXXX------X-X-----X---X-XXXXXXXXX---XXXXX-----XX---XXXXX-----XXXXX--XXXXX---XXX-----XXXXXXXX---XXXX----------XX-----XXXX-X----XXX---X-X---XXX---XXXX-E---XX-----X---XX-XXX--X--
