-----X----------X-X--S-------------------------X-S---------------------X-------X--------X----------------------------------------------------X----X-----------------------------S--------S----------------
XX---X----------X-X----------------------------X-----------------------X-----E-X--------X--------------------------------------------------S-X----X---E-------------X---------------X------------------Q--
XX---X-------E--X-X-------E--------------------X-------S---------------X-------X--------X--------S--X------------------E----<>---------------X----X----------X------X--------XX-----X---------------------
XX---X-Q--------X-X-----------?---X------------X-----------------------X-------X--X-----X-----------X-----X-----------------[]--------X------X----X----------X------X--------XX-----X-----------S-------XX
XX---X----------X-X-S--X--------X-X----------E-X-----<>----------------X-------X-XX--E--X-----S----XX-----X-----------------[]---X----X------X----X----------X----X-XX---S---XX-----X---Q---------------XX
XX---X----------X-X----X--------X-X------------X-----[]----------------X-------X-XX-----X-------XX-XX-----X-----S----------XXXX--X----X------XX---X-------X--X----X-XX-------XX-----X-------------------XX
XX---X----------XXX----X--------X-X------------X-----[]------X---------X-------X-XX--X--X-------XX-XX-----X----------------XXXX--X---XX------XX-S-X-------X--X----X-XX-------XX----XX-?-----------------XX
XX---X----------XXX----X--------X-X--------X---X-----[]------X--------XX-------X-XX--X-XX---X---XX-XXX----X----------------XXXX--X---XX------XX---X-------X--X----X-XX-------XXX---XX------------S------XX
XX---XX--X--X---XXX----X--------X-X--------X---X-----[]------X--------XX-X-----X-XX--X-XX---X---XX-XXX---XX----------------XXXX--X---XX------XX---X-------X--XX---X-XX-------XXX---XX-------------------XX
XX---XX--X--XX--XXX----X--------X-X-------XX---X-----[]------X--------XX-X-----X-XX--X-XX---X---XX-XXX---XX-Q--------------XXXX--X---XX------XX---X-------X--XX---X-XX-------XXX---XX-----------X-------XX
XX---XX-XX--XX--XXX----X--------XXX-------XXX--XX----[]------X--------XX-X-----X-XX--X-XX---X---XX-XXX---XX----------------XXXX--X---XX------XX---X-------X--XXX--X-XX-------XXXX--XXX----------X-------XX
XX---XX-XX--XX--XXX----X--------XXX-------XXX-XXX----[]------X------?-XX-X-----X-XXX-X-XX---X---XX-XXX---XX-------X--------XXXX--X---XX------XX---X-------X--XXX--XXXX-------XXXX--XXX----------X-----E-XX
XX---XX-XX--XX--XXX----XX-------XXX------XXXX-XXX---XXXXX---XX----S---XX-XX----X-XXX-X-XX---X---XX-XXX---XX------XX--------XXXX--XX-XXX----S-XX---X-------XXXXXX--XXXX--X----XXXX--XXX--Q-------X-------XX
XX-XXXXXXX--XX-XXXX----XX-------XXX------XXXX-XXX---XXXXX---XX--------XX-XX----X-XXX-XXXX---X---XXXXXX---XXX----XXX----Q---XXXX--XX-XXX------XX---X-------XXXXXX--XXXX--X----XXXX--XXX----------X-------XX
