S-E-----------Q-----------------------X-------S---------------XXX-------------------------------------------------------------------------[]---------------------------------------------------------X----
--------------------X------S----------X--------------X--------XXX----------<>----X--X----------Q------------------X---------------------Q-[]---------------------------------------------------------X----
--------------------X----X-----X------X---------E----X--------XXX----------[]X---X--X-----------------------------X------X----------------[]------------------------------X------X-------------------X----
--------------------X----X-----X------X--------------X--------XXX---------XXXX---X--X-------------------X-------X-X------X---------------XXXX-------S---Q-----------------X------X-------------------X----
------------S-----X-X----X-----X------X--------------X--------XXX---------XXXX---X--X-------------------X-------X-X------X--X------------XXXX-----------------------------X---X--XX-----------------XX-X--
-----E---X-------XXXX----X-E---X------X----------X-E-XX-------XXXX--------XXXX---X--XX-----X----X-------X-------X-X------X--X------------XXXX---X-----S-------------------X---XXXXX-----------------XX-X--
---------X--E----XXXX----XXXX--X------X-------E--X---XX-------XXXX--------XXXX---X--XX-----X----X-------X-----X-X-X------X--X------------XXXX---X------------XX-X-----S-S-X---XXXXX-----------------XX-X--
---------X----S--XXXX----XXXX--XX-----X----------X---XX-------XXXX--------XXXX-X-X--XX-----X----X--X----X-----X-X-X----S-X--X------------XXXX---X------------XX-X---------XX--XXXXXX--------------E-XX-X--
XX---Q---X-------XXXX----XXXX--XX-----X-----X----X---XX----S--XXXX--------XXXXXX-X--XX-X---X----X--X----X-----X-X-X------X--XX-----------XXXX---X------------XX-X---------XX--XXXXXX----------------XXXX--
XX-------X-------XXXX----XXXX--XX-----X-----X----X---XX-------XXXX--------XXXXXX-X--XX-XX--X----X--X-S--X-X---XXX-X------X--XXX----E-----XXXX---X--------S---XX-X---------XX--XXXXXX----------------XXXX--
XX-------X-------XXXX----XXXX--XX-----XX----X----X---XX------XXXXX--------XXXXXX-X--XX-XX--X----X--X----X-X---XXX-X-S-S--XX-XXX----------XXXX---X------------XX-X---------XX--XXXXXX---X------------XXXX--
XX-------X-------XXXX----XXXX--XX-----XX----X----X---XX---<>-XXXXX------E-XXXXXX-X--XX-XX--X----X--X----X-X---XXX-X------XX-XXXX---X-----XXXX---X----------X-XXXX-S-------XX--XXXXXX---X----------E-XXXX--
XX-------X-------XXXX----XXXX--XX-----XX----XX---X---XX---[]-XXXXX-----XXXXXXXXX-X--XX-XXXXX-XX-X--XX---X-X---XXX-X------XXXXXXXX--X-----XXXX---X----------X-XXXX---------XX--XXXXXXX--X------------XXXX--
XX-E-----X-------XXXX----XXXX--XX-----XX----XX---X---XX--XXXXXXXXXX---XXXXXXXXXXXX-XXX-XXXXX-XXXX--XX---X-X---XXXXX-----XXXXXXXXX--X-----XXXXX--X----------X-XXXX---------XX--XXXXXXX--X-------X----XXXX--
