E-----------------------[]---------------------E--------------------------S------S-X----------------------------E-----------X-X------------------------------------E--------------------------------------
---------------------S--[]-------------------------E----------X--------------------X---S-----------------------------E------X-X-----X----------------------------------------------S----------------------
-----X------------------[]------------------------------------X--------------------X------------------------X--Q------------X-X-----XX------X----------------------X-----------X-------------Q------------
-----X----------------X-[]----------S-------------------------X-----------E--------X-X-----------X----S-----X---------------X-X-----XX------X----------------------X-----------X---------------E----E-----
-----X----------------X-[]--X-----Q---------------------------X--------------------X-XX----------X--X---X---XX-----------X-XX-X-----XX------X--------------X-------X-----<>-X--X----------------------E---
-----X--------------X-X-[]--X---------------------X-----------X---------------X----X-XX----------X--X---X---XX-----------X-XX-X-----XX------X------------X-X-------X-----[]-X--X--------------------------
-----X--------------XXXXXXX-X---------------------XX-X--------X----------X----X----X-XX-X--------X--X---X---XX--S--------X-XX-X-----XX------X------------X-X----<>-X---S-[]-X--X-X-----Q------------------
-----X--------X-----XXXXXXX-X-----X------S--------XX-X-------XX----------XX---X----X-XX-XX-------X--X---X---XXX---------XX-XX-X-S---XX------X------------X-X----[]XX-----[]-X--X-X-----------E---S--------
-----X--------X-----XXXXXXX-X-----X---------------XX-X----?--XX----------XX---X----X-XX-XX-------XX-X---X---XXX----E----XX-XX-X-----XX------X------------X-X---XXXXX-----[]-X--X-X---X---S-----E----------
-----X----X---X-----XXXXXXX-X-----X---------------XX-X-------XX----------XX---X----X-XXXXX-------XX-X---X---XXX---------XX-XX-X-S---XX------X------------X-X---XXXXX-----[]-X--X-X---X--------SSS------S--
-----X---XX---X-----XXXXXXX-X-----X------------E--XX-X-------XX---X------XX---X----X-XXXXX-------XX-X---X---XXX---------XX-XX-X-----XX------X------------XXX---XXXXX-----[]-X--XXX---X--------------------
-----X---XX---X-----XXXXXXX-X-----X-----------XXX-XX-X-------XX---X------XX---X----X-XXXXX-------XX-X---X---XXX---------XX-XX-X-S---XX------X------------XXX---XXXXX-----[]-X--XXX---X--------------------
-----X---XX---X-----XXXXXXXXX-----X-----------XXX-XX-X-------XX---X------XX---X----X-XXXXX----X--XXXX---X-S-XXX---------XX-XXXX-----XX---X--X--E---------XXX---XXXXX----XXXXX--XXX---X----X---------------
--E-XX---XX---X-----XXXXXXXXX-----X-----------XXX-XX-X-------XX---X------XX---X----X-XXXXX----X--XXXX---X---XXX---------XX-XXXX-----XX---X--X-----------XXXX-E-XXXXX---XXXXXX--XXX---X--E-X-------XX-----E
