-----------------------------------------------------------------------X-----------------------------------------------------------------------------------------X---?---------X--------S-----------------
------S---X-------------------------------X------------------------X---X-----------------------------------X--------------X-----------------------------X--------X-------------X--------------------------
----------X------------Q------------------X--------------------SS--X---X-----------------------------------X--------X-----X-----------------------------X----X---X-------------X--------------------------
-------X-XX--------------E----X---------E-X-X------S-------X-------X---X-------------------------X---------X--------X-----X----------------------------XX----X---XX----S---X---X--------------------------
-------X-XX----X------X-------X-X-----X---X-X--------------X-------X---X-------------------------X---------XX-------X-----X----------------X-----------XX----X---XX--------X---X-------------E------------
-------X-XX----X------X----S--X-X-----X---X-X--------------X--X----X---X------X--X---------------X---------XX----<>-X-----XX---X--------X--X-----------XX----X---XX-------XX---X--------S--S------X-----SS
---X---X-XX----X------X-------X-X-----X---X-X--?---X-------X--X----X---X----E-X--X----X-------X--X---X-----XX----[]XXX--X-XX---X--------X--X-----------XX----X---XXX------XX---X------------------X-------
--XX---X-XX----XXX----X-------X-X-----X---X-X------X-------X--X----X---X------X--X----X-------X--X---X-----XX---XXXXXX--X-XX---X--------X--X-----------XX----X---XXX--E---XX---X------------------X----E--
--XX---X-XX--E-XXX----X-X----XX-X-----X---X-X-----XX-------X--X----X---X------X--X----X-------X--X---X-----XX---XXXXXX--X-XX---X-E------X--X-----------XX----X--XXXX------XX--XX--------------X---X-------
--XX---X-XX----XXX----X-XX---XX-X-----X---X-X-----XX-------X--X----XX--X------X--X----X-------X--X---X-----XX-X-XXXXXX--X-XX---X--------X--X-----------XX-E--X--XXXX-----XXX--XX------X-------X---X--X----
--XX---X-XXX---XXX-E--XXXX---XX-X---X-X---X-X-----XX--X----XX-XX---XX--X------X--X----X-X----XX--X---X----XXX-X-XXXXXX--X-XX---XX-------X--X-----------XX----X--XXXX-----XXX--XX---X--X--X----X---XX-X----
XXXX---X-XXX---XXXXXX-XXXX---XX-X---X-X---X-X-----XX--X----XX-XXX--XX--X------X--X----X-X-X--XX--X---X----XXX-X-XXXXXX--X-XXX--XX-------X--X-----------XX----X--XXXX-----XXX--XX---X--X--X----X-X-XX-X----
XXXX---X-XXXX--XXXXXX-XXXX---XX-X---X-X---X-X-----XX--X----XX-XXX--XX--X------X--X-X--XXX-X--XX--X---X-S--XXXXXXXXXXXX--X-XXX--XX-------X--X-----------XX----X--XXXX-----XXX--XX---X--X--X----XXXXXX-X----
XXXX--XX-XXXX--XXXXXXXXXXX---XX-X---X-X---XXX-----XX--X----XX-XXX--XX--X------X--XXX--XXX-X--XX--XX--X----XXXXXXXXXXXX--X-XXX--XX-------X--X-----S-----XX----X--XXXX-X---XXX--XX---X--X--X----XXXXXX-X----
