S---[]---------X---------------------------XX-----------<>------------[]----------------X-----------------------X-------------------------------------------[]-------------------X---?--------------------
----[]---------X---------------------------XX-S---------[]------------[]-----X------X---X-------------------S---X-------------------------------------------[]-----------------X-X----------------------X-
--E-[]---------X---------------------------XX----S------[]--X---------[]-----X------X---X--------XX--X----------X------X------------------XX-X--------------[]-E-X-------------X-X-------S--------------X-
----[]---------X-----X---------------X-----XX-----------[]--X---------[]---E-X------X---X--------XX--X----------X------X---------X--------XX-X--------------[]---X-----X---X---X-X------------------X---X-
----[]---------XX----XX----------X---XX----XXXX---------[]--X--------XXXX----X------X---X-----E--XX--X----------X------X---------X--------XX-X--------------[]---XX----X---X---X-X----X----E--------X---X-
--XXXXX--------XX----XX----------X---XX----XXXX---------[]--X--------XXXX----X------X---X--X-----XX--X------X-X-XX-X---XX-------XX--------XX-X--------------[]---XX----X---X---X-X----X------S------X---X-
--XXXXX-----X--XX----XX--X-----X-X---XXX---XXXX---------[]--X--------XXXX----X------X---X--X-----XX--X------XXX-XX-X---XX-------XX-X------XX-X--------------[]---XX----X---X---X-X----X-------------X---X-
--XXXXX-----XXXXX----XX--X-----X-X--XXXXX--XXXX---------[]--XX-X-----XXXX----X------X---X-XX-----XX--X------XXX-XX-X---XX-------XX-X----E-XXXX--------------[]---XX----X---X---X-X----X--------X----X---X-
--XXXXX-----XXXXX----XX--X--S--X-X--XXXXX--XXXX---------[]--XX-X-----XXXX----X-----XX---X-XX-----XX--X------XXX-XX-X---XX-------XX-X------XXXX--------------[]---XX---XX---X---X-X----X--------X----X--XX-
--XXXXX-----XXXXX----XX--X-----X-X--XXXXX--XXXX---------[]--XXXXX----XXXX----X-----XX---X-XX-----XX--X----X-XXX-XX-X---XX-------XXXX------XXXX----------X---[]---XX---XX---X---X-X----X--------X-X--X--XXX
--XXXXX-----XXXXX----XX--X----XX-X--XXXXX--XXXX---------[]--XXXXX----XXXX----X----XXX---X-XX-----XX--X---XX-XXX-XX-X---XX-------XXXX------XXXX----------X---[]---XX---XX---X---X-X----X--------X-X--X--XXX
--XXXXX----XXXXXX-S--XX--X----XX-X--XXXXX--XXXX--------XXXX-XXXXX----XXXX----X----XXX---X-XX-X---XX--X---XX-XXX-XXXX---XXX------XXXX------XXXX----------X-Q-[]---XX---XX--XX---X-X----XX----X--X-X--X--XXX
--XXXXX----XXXXXX----XXXXX----XX-X--XXXXX--XXXX--------XXXX-XXXXX----XXXX----X----XXX---X-XX-X---XX--X---XX-XXX-XXXX---XXX-----XXXXX------XXXX----------X---[]---XX---XX--XX---X-X-XX-XX----X--X-X--X--XXX
--XXXXX----XXXXXX----XXXXX----XX-X--XXXXX--XXXX-------XXXXXXXXXXX-X--XXXX----X----XXX---X-XX-X---XX--X---XX-XXXXXXXX---XXX-----XXXXX------XXXX----------X--XXXX--XX---XX--XX--XX-X-XX-XX----X--XXX--X--XXX
