----------X-[]---------------------[]--Q-----------------------------------------S---------------------------------E-----X----Q----------X----------------Q------X-------------X--------------------------
---S------X-[]---------------------[]-------------------------------------------------------------X------X-------------X-XX-X------------X-----------------------X------X------X-------------------------<
----------X-[]---------------------[]---------------------------------------------------X---------X------X-------------X-XX-X----------X-X----X------------------X----Q-X---X--X---------------------S---[
X---------X-[]---------------------[]------------------------E--------------------------X---------X-----XX-----------X-XXXX-X----------X-X----X------------------X------X---X--X------<>-----------------[
X-----X-X-X-[]----------------X----[]---------------------------------------------------X---------X-----XX-----------XXXXXX-X--X-------X-X----X--------------X---X--X---X---X--X------[]-----------------[
X-----X-X-XXXXX---------------X----[]---------X----------------S-?-----------X----------X----X----X-----XX-----------XXXXXX-X--X-------X-X----X--------------X---X--X-X-X---X--X------[]----------------XX
X-----X-X-XXXXX---------------X----[]---------X------------------------------X---------XX----X-X--X-----XX-------X---XXXXXX-X--X-------X-X----X-----S--------X---X--X-X-X---X--X------[]----------------XX
X-----X-X-XXXXX------E--------X----[]-X-X-----X----------X---------X--X------X---------XX----X-X--X-----XX-------X---XXXXXX-XX-X-------X-X----X--------------X---X--X-X-X--XX--X------[]----------------XX
X-----X-X-XXXXX-----------<>--X----[]-X-X---X-X----------X---------X--X------X---------XX-X--X-X--X-----XX-------X---XXXXXX-XXXX-------X-X----X--------------X---X--X-X-X--XX--X----S-[]-------X--X-----XX
X-----X-X-XXXXX-----------[]--X----[]-XXXX--X-X----------X---------X--X------X---------XX-X--X-X--X-----XX-------X---XXXXXX-XXXX-------X-X----X--------------X---X--X-X-X--XX--X------[]-------X--X-----XX
X-----X-X-XXXXX-----------[]-XX----[]-XXXX--X-XX-XX------X---------X--X-X----X---------XX-X--X-X--X-----XX-------X---XXXXXXXXXXX-------X-X----X-----X--------X---X--X-X-X--XX--X------[]-------X--X-----XX
X-----X-X-XXXXX-----------[]-XX---XXXXXXXX--XXXX-XX----X-X---------X--X-X----X---------XX-X--X-X--X----XXX-------X---XXXXXXXXXXX-------X-X----X-----X----X---X---X--X-X-X--XXXXX-----XXXX------X--X-----XX
X----XX-X-XXXXXX---------XXXXXX--XXXXXXXXX--XXXXXXX----X-XX-------XX--X-X----XX--------XX-X--X-X--XX---XXXX--X---X---XXXXXXXXXXX-------X-X----X-----X----X---X---X--X-X-X--XXXXX-----XXXX------X--X-----XX
X----XXXX-XXXXXX---------XXXXXX--XXXXXXXXX--XXXXXXX----XXXX-------XXXXX-X---XXX--------XXXX--XXX--XX---XXXX--X-XXX---XXXXXXXXXXX-------XXX----X---X-X----X---X---X--X-XXX--XXXXX-----XXXX---XX-X--X--X-XXX
