-------S-------------XX--X-----------------------------X------------------------------<>-S----------------------------------------------------------------------------------------------------------------
---------------Q-----XX--X----X-----------------E--<>--X------X-----------------------[]-------------X----------X---X-----------------------------------------------------------------------X-------------
S--------------------XX--X----X--------------------[]-XX------X-X---------------------[]-------------X-S--------X---X---------------------------X----------S--------------------------X-----X----X------E-
---------------------XX--X----X--------------------[]-XX------X-X-----------X---------[]-------------X----------X---X---------------------------XX-----------------------------------XX-X---X----X--E-----
X--------------Q-----XX--X----X--------------------[]-XX------X-X-----------X-<>------[]-------------X----------X---X--------X------------------XX---X-------X-----------------------XX-XX--X----X-------X
X--------------------XX--X----XXX------------------[]-XX------X-X-----------X-[]------[]----X--------X----------XX--X--------X--XX--------------XX---X-------X------------------E----XX-XX--X----X-------X
X------X--X-E--------XX--X----XXX----------S-------[]-XX------X-X-----------X-[]------[]----X--------X----------XX--X--------X--XX---?----------XX---X------XX-----X-X-------X-------XX-XX--X----X-------X
X------X--X----------XX--X----XXX--S---------------[]-XX------X-X-----------X-[]------[]----X---X-S--X-Q--------XX--X----X---X--XX--------------XX---X------XX-----X-X-------X-------XX-XX--X----X-------X
X------X--X----------XX--X----XXX------------------[]-XX------X-X-----X---Q-X-[]------[]----X---X----X----------XX--X----X---X--XX--------------XX---X------XX-----X-X-S-----X-------XX-XX--X---XX-------X
X------X--X----------XX--X----XXXX-----------------[]-XX------X-X-----X-----X-[]-----XXXX---X---X----X----------XX--X--X-X---XX-XX--------------XX---X-X----XX---X-X-X-------X-----E-XX-XX--XX--XXX------X
X------X--X----------XX--X----XXXX--------X--------[]-XX------X-XX----X-----X-[]-----XXXX---X---X--X-X----------XX--X--X-X--XXX-XX---------E----XX---X-X----XX---X-X-X-X-----X----XXXXX-XX-XXX--XXX------X
X------X--X--------S-XX--X----XXXX--------X--------[]-XX----X-X-XX----X-----X-[]-----XXXX---X---X--X-X----------XX--X--X-X--XXX-XX-------------XXX---X-X----XX---X-X-X-X-X---XXX--XXXXX-XXXXXX--XXX------X
XX-----X--X----------XX--X-E--XXXX--------X--------[]-XX----X-X-XX----X-----XXXXX----XXXX---X-X-X--X-X----------XX--X--X-X--XXX-XXX--X--X------XXX---X-X----XX---X-X-X-X-X---XXX--XXXXX-XXXXXX--XXX------X
XX-----X--X----------XX--X----XXXX--------X----S---[]-XX----X-X-XX----X-----XXXXX----XXXX---XXXXX--X-X----------XXXXX--X-X--XXXXXXX--X--X------XXX---XXX----XX---XXX-X-X-X---XXX--XXXXX-XXXXXX--XXX------X
