------------X----------------------------XX-?---------------------X----X------------------------------------------------------------------------------Q---------------[]---------------------------------X
------------X----------------------------XX-----------------------X---XX---------X-----------------------<>--------------------------X--------------------------------[]---------------------------------X
----X-------XX--<>-------X--------X-----XXX---------------S-------X---XX---------X-----------------------[]--------------------------X----------------X---------------[]--------E-E----------------------X
---XXX-X----XX--[]-------X--------X-----XXX----S------------------X---XX---------X-----------------------[]--------------------------X----X-------X---X-----S-------X-[]----------------------S----------X
---XXX-X-S--XX--[]-------X---X----X-----XXX-----------------------X---XX---X-----X----------------------XXXX-------------------------X----X--X----X---X-------------XXXXX--------------------------------X
---XXX-X----XX--[]-------X---X----X-----XXXX----X-----------------X---XX---X-----X--X-------------------XXXX--S----------------------XX---X--X----X---X-------------XXXXX-------------------E------------X
---XXX-X----XX--[]-------X---X----X-----XXXX---XX-----------------X---XX--XX----XX--X-------------------XXXX---------------------X---XX---X--X----X---X------X------XXXXX----------X-X--E-----X------S---X
---XXX-XX---XX--[]-------X---X--XXX---XXXXXX---XX---XX------------X---XX--XX----XX--X--------X------S---XXXX---S----------XX-----X---XX---X--X---XX---X--X---X------XXXXX-----X----X-X--------X----------X
---XXXXXX---XX--[]-------X---X--XXX---XXXXXX---XX---XX-----S-----XX---XX--XX----XX--X--E-----X----------XXXX------------X-XXX----X---XX---X--X---XX---X-XXX-XX--X--XXXXXXX---XX----X-X--------X----------X
---XXXXXX---XX--[]-------X---X--XXX---XXXXXXXX-XX---XX-----------XX---XX--XX----XX--X--------X----------XXXX-S----------X-XXX----X---XX---X--X---XX---X-XXX-XX--X-XXXXXXXX---XX-?--X-X--------X--E-------X
---XXXXXXX--XXX-[]------XX---X-XXXX---XXXXXXXX-XX---XX------S----XX---XX--XX----XX--X------XXX----------XXXX------X-----X-XXX----X---XX---X--X---XXX--X-XXX-XX--XXXXXXXXXX---XX----X-X-------XX----------X
---XXXXXXX--XXXXXXX-----XX---XXXXXX---XXXXXXXX-XX---XX----X------XX---XX--XXX---XX--X------XXX---<>----XXXXX------X-----X-XXX----X---XX---X--X---XXX--X-XXX-XX--XXXXXXXXXX---XX---XX-X--X----XXX---------X
---XXXXXXX--XXXXXXX-Q---XX---XXXXXX---XXXXXXXX-XX---XX---XX------XX---XX--XXX---XX--X------XXX---[]----XXXXX-S----X---XXXXXXX----XXX-XX---X--X---XXXXXXXXXX-XX--XXXXXXXXXX---XX---XX-X--XX---XXX--------XX
---XXXXXXX--XXXXXXX-----XX---XXXXXXX--XXXXXXXX-XX---XX---XX------XX---XX--XXX---XX--X------XXX---[]----XXXXX------X-XXXXXXXXX----XXX-XX---X--X---XXXXXXXXXX-XX-XXXXXXXXXXX---XX---XXXX--XX---XXX--------XX
