--------------------------------------S-X----------------------------------------------------------------------X------------------------------------X-------------S--X----------------------------X-------
------S---------------------------------X--------------------------------------------------------X-------------X------------------------------X-----X----------------X-------------X--------------XX------
---------------<>-----------------Q-----X--------------X----------------------------Q------------X-------------X----------X------S------------X-----X---X------------X----Q--------X--------------XX------
--------X--S-E-[]-----X-----------------X------------X-X---------?----XX---S-------------------S-X-------------X----------X--------------S----X-S---X---X------------X-------------X--------------XX------
--------X------[]----XX---------X--X----X------------X-X--------------XX--------------Q----------X-------------X----------X---X---X-----------X-----X---X---X--------X-------------X--------------XX------
--------X-----XXXX---XX---------X--X----X------------X-X--------------XX--------------------S----X-------------X----X-----X---X---XX-X--------X-----X---XXXXX-----X--X----E--------X---S----------XX------
--------X-----XXXX---XX---------X--X----X------------X-X-----X--X-----XX------E---S--------------X-------------X----X-----X---X---XX-X-----X--X-----X---XXXXX-----XX-XXX-----------X--------Q-----XX------
--------X-----XXXXX--XX---------X--X----X--S-------X-X-X-----X--X-----XX---------------------S---X-------------X----X-----X---X---XX-XX----X--XX----X---XXXXX-----XX-XXX-----------X------------X-XX------
--SQ----X-----XXXXX--XX--?------X-XX----X----------X-X-X-----X-XXX----XX---------------X---------X--------XX---X----X-----X---X---XX-XXX---X--XX----XX--XXXXX-----XX-XXX-----------X------------X-XX------
--------X-----XXXXX--XX---------XXXX----X---X---<>-X-X-X-----XXXXX----XX--------S?-----X--X------X-X------XX---X----X-----X---X---XXXXXX-X-X--XX----XX--XXXXX-----XX-XXXX----------X------------X-XX------
--X-----X-----XXXXXX-XX---------XXXX----X---X---[]-X-X-X-----XXXXX----XX-----------X---X--X------X-X------XX---X----X-----X---X---XXXXXX-X-X--XX---XXX--XXXXX-----XX-XXXX----------X------------X-XX------
--XX----X-----XXXXXX-XX---------XXXX----X---X---[]-XXX-X-----XXXXX----XX-----------X---X--X------X-X----X-XX---X----XX---XX---XX--XXXXXX-X-X--XX--XXXX--XXXXX-----XX-XXXXX---------X------------X-XX------
--XXXX--X-----XXXXXX-XX---------XXXX----X---X--XXXXXXX-X-----XXXXX----XX-----------X---X--X------X-X----X-XX---X----XX---XX---XX--XXXXXX-X-X--XX--XXXX--XXXXX-----XX-XXXXX-E-------X------------X-XX------
--XXXX--X-----XXXXXXXXX---------XXXX----X---X--XXXXXXX-X--X--XXXXX----XX--S--------X---X--XX-----X-XXX--X-XX---X----XX---XX---XX--XXXXXX-XXX--XX--XXXX--XXXXX-----XX-XXXXX---------X----X------XXXXX------
