----S-----------------------------------------------E-----<>------------------------XX--------S----------------------------------------------------------------------X-Q----------------------------------
-----------------------------------------X----------------[]X---------XX------X-----XX------------------------------S-<>------E--------S-----------------------------X------------------------------------
-------E----------X----------------------X---------------XXXX--X------XX------X-----XX----------------X---------------[]---------------------------------------------X---------------------<>-------------
------------------X-----X----------------X--E------------XXXX--XX-----XX------X-----XX----------------X---------------[]------X--------------------------------------X---------------------[]-------------
------------------X---X-X----------X--E--X-----------S---XXXX--XX-----XX--S---X----XXX------------S---X---X-----------[]-X----X---X--X-------------------------------X---------------------[]-------------
------------X-<>--X---X-X----------X-----X-----X---------XXXX--XX-----XX------X-X--XXX-<>-------------X---X-----------[]-X----X---X--X-------------------------------X---------------------[]-------------
----------X-X-[]--X---X-X----------X-----XX----X---------XXXX--XX-----XX------XXX--XXX-[]-------------X---X-----------[]-XX---XX--XXXX-----E-----S-----------X-------X----------?----------[]-------------
-------<>-X-X-[]-XX---X-X----------X---E-XX----X--------XXXXX--XXX----XX------XXX--XXX-[]-------------X---X----S------[]-XX---XX--XXXX----------------X------X-------X-------------X--E----[]-------------
-------[]-X-XXXXXXX---XXX----------X-----XX----X----<>--XXXXX--XXX----XX-----XXXXX-XXX-[]-------------X---X-----------[]-XX---XX--XXXX----------------X------X-------X-------------X-------[]-XX----------
----X--[]-X-XXXXXXX--XXXXXX--------X-----XX---XX----[]--XXXXX--XXX----XX-----XXXXX-XXX-[]-------------X---X-----------[]-XX---XX--XXXX----------------X------X-------X------------XX-------[]-XXX--X------
----X--[]-X-XXXXXXX--XXXXXX----X---X-----XX---XX-E--[]--XXXXX--XXX----XXX--X-XXXXX-XXX-[]--------Q----XX--X-----------[]-XX---XX--XXXX---------------XX-X----X-------X--X---------XX---X---[]-XXX--X------
----X--[]-X-XXXXXXX--XXXXXX----X---X-----XX---XX----[]--XXXXX--XXX----XXXXXXXXXXXX-XXX-[]-------------XX--X---------X-[]-XX---XX--XXXX---------------XX-X-X--X-------X--X---------XX---X--XXXXXXX--X------
----X--[]-X-XXXXXXX--XXXXXXX---X---X-----XX---XX----[]-XXXXXX--XXX----XXXXXXXXXXXXXXXX-[]-------------XX--X---------XXXXXXX---XX--XXXX---------------XX-X-X--X-------X--X---------XX---X--XXXXXXXX-X-----E
----X--[]-X-XXXXXXX--XXXXXXX---X---X-----XX---XX--XXXXXXXXXXX--XXX---XXXXXXXXXXXXXXXXX-[]----X--------XX--X-X-------XXXXXXX---XX--XXXX----X-------X--XX-X-X--XXX-----X--X---------XXX--X--XXXXXXXXXX------
