-------S------------------X-X---------X----X----------------------------X-----------S---------------------------------------------------------------------X-------------------S-------------[]--------S---
------------------------X-X-X---------X----X--------X-------X-----------X-------X--------X---------------------Q-----E--------------------------E---------X------Q--------------------------[]----X-------
------------------------XXX-X---------X----X----X---X------XXXX---------X-------X--------X-X------S-------------------------------------<>----------------X---------------X----------X------[]----X--X----
---------------<>-------XXX-X---------X----X----X---X------XXXX-----X---X-------X-X------X-X--------------------X----------E---X-X------[]----------------X--------XX-----X---X-X-Q--X------[]--X-X--X----
-X-------------[]-------XXX-X---------X----X----X---X------XXXX-----X--XX-------X-X------X-X--------S-----------X-Q------------X-X------[]----------------X--------XX-----X---X-X----X-----XXXX-X-X--X----
XX-S-----------[]-------XXX-X-------X-X----X----X---X------XXXX-----X--XX-------X-X------X-X------------------X-X----<>-------XXXX-----XXXX---------------XX-----?-XX-----X---X-X----X-XX--XXXX-X-X--X----
XX------------XXXX------XXX-X-------X-X----X----X---X---Q--XXXX-----X--XX-------X-X------X-X------------------X-X----[]--S----XXXX-----XXXX--------------XXX-------XX-----X---X-X----X-XX--XXXX-X-X-XX----
XX------------XXXX------XXX-X-------X-X----X----X--XX-----XXXXX-----X--XX-XX----X-X------XXX--------------X---X-XX---[]-------XXXX-----XXXX----------E---XXX-------XX-----X---X-X----X-XX--XXXX-X-X-XX----
XX-X---E------XXXX-----XXXX-X-------X-XX---X----X--XX-----XXXXX-----X--XX-XX----X-X------XXXX-------------X---X-XX---[]-------XXXX-----XXXX--------------XXX-------XX-----X---X-X-?-XX-XX--XXXX-X-X-XX----
XX-X-------X--XXXX-X---XXXX-X-------X-XX---XX---X--XX-----XXXXX-----X--XX-XX----X-X------XXXX-------------X---XXXX---[]-------XXXXX----XXXX-------------XXXX-------XX-----X---X-X---XX-XXX-XXXX-X-X-XX----
XX-X---X--XX--XXXXXX---XXXX-X-------XXXX---XX---X--XX-----XXXXX-----X--XX-XX----X-X--X---XXXX------------XX---XXXX---[]-----X-XXXXXX---XXXX------------XXXXX-------XX-----X---X-X---XX-XXX-XXXX-X-X-XXX---
XX-X---X--XX--XXXXXX---XXXX-X-------XXXX---XX---X--XX-----XXXXX-S---X--XX-XX----X-X--X---XXXX-------Q----XX---XXXX---[]-----X-XXXXXX---XXXX---Q--------XXXXX-------XX-X---X---X-X---XX-XXX-XXXX-X-X-XXX-E-
XX-X---X--XX--XXXXXX---XXXX-X-------XXXX---XX-XXX--XX-----XXXXX-----XX-XX-XX----XXX--X---XXXX------------XX---XXXXXX-[]-----X-XXXXXX---XXXX--------X---XXXXX-------XX-X---X---X-XX--XX-XXX-XXXX-XXX-XXX---
XX-X---X--XX--XXXXXX---XXXX-X------XXXXX---XX-XXX--XX---XXXXXXX--Q--XX-XX-XX----XXX--X---XXXX-------X----XX---XXXXXXXXXXX---XXXXXXXX---XXXX--------X---XXXXX--X----XX-X---X---X-XX--XXXXXX-XXXX-XXXXXXX---
