---------S-------X---------------X----------------------------X------------<>-------X---------------E---------------------------Q------------------------------X-------------[]---------------------------
-----------------X-S-------------X----------------------------X------------[]-----X-X--------------------------------------------------------------------------X-------------[]----------X------<>-------E
-----------------X------S--------X----------------------------X------------[]-----XXX--------<>-<>-------------X--------------------X-X-----------X-X--<>------X-------------[]----------X------[]--------
--E--------------X---------E-----X--------S--------X----------X-----------XXXXX---XXX--------[]-[]--Q----------XX---------X---------X-X-----------X-X--[]------X-------------[]----------X------[]--X-----
----Q------------X------S--------X-----------------X----------X-------X---XXXXX---XXX--------[]-[]----X--------XX---------XX--------X-X-----------X-X--[]-----XX------------XXXX---------X------[]--X-----
-----------------X---------------X-----------------X--S-------X-------X---XXXXX---XXX-------XXXXXXX---X-------XXX---------XX--------X-X---------X-X-X--[]-----XXX-----------XXXX---------X------[]--X-----
-----------------X------X--------X--X--------------X----------XX------X---XXXXX--XXXX-------XXXXXXX---X--S----XXX---------XX--------X-X---------X-X-X--[]-----XXX------E--X-XXXX---------X---S--[]--X-----
-----------------X---S--X--------X--X--------X-----X--X-------XXX-----X---XXXXX--XXXX-E-----XXXXXXX---X-------XXX-------X-XX--------X-X-X--X----X-X-X--[]-----XXX---------X-XXXX--Q------X-----XXXX-X-----
-----------------X------XX---XX-XX--X--------X-----X--X-------XXXX----X---XXXXX--XXXX-------XXXXXXX---X-------XXX-------X-XX--------X-X-XX-X---XX-X-X-XXXX--S-XXX---------X-XXXXX--------X---X-XXXX-XX----
-----------------X------XX---XX-XX--X--------X-----XX-X-------XXXX----X---XXXXX--XXXX-------XXXXXXX---X-------XXX-------X-XXX-------X-X-XX-X---XX-XXX-XXXX----XXX---------X-XXXXX--------X---X-XXXX-XX----
-----------------X------XX---XX-XX--X--------X-----XXXX----Q--XXXX----X---XXXXX-XXXXX-------XXXXXXX---X-------XXX-------X-XXX-------X-XXXX-X---XX-XXX-XXXX----XXX-X-------X-XXXXX----S---X---X-XXXXXXX----
------------E----X------XX---XX-XX--X--------XX----XXXX-------XXXX-E--X---XXXXXXXXXXXX------XXXXXXX---X-S-----XXX-E-----X-XXX-------X-XXXXXX---XX-XXX-XXXX----XXX-X-------X-XXXXX--------X---X-XXXXXXXX---
-----------------XX---X-XX---XX-XX--X----S---XX----XXXX-------XXXX----X---XXXXXXXXXXXX------XXXXXXX---X-------XXX-------X-XXX-------X-XXXXXX---XXXXXX-XXXX----XXX-X-------X-XXXXX-------XX---X-XXXXXXXX---
-----------------XX---XXXX---XX-XX--X-------XXX----XXXX-------XXXX----X-XXXXXXXXXXXXXX------XXXXXXX---X--X----XXX-------XXXXX-------X-XXXXXX---XXXXXXXXXXXX---XXXXX-------XXXXXXX------XXX---XXXXXXXXXX---
