-----------------------E---------------------------------------E---------X------------------------------S----------------------------------------X--------------X------X--X-----------------X----S-----E--
-------------X-----X-------------------X---------------------------------X------------------------------------------XX------------------X--------X---S-------S--X-----XX--X-----------------X-------------
-------------X-----X-------------------XX--------X-E---E-----X-----------X------------------XX---------X---------X--XX----------S-------X--------X--------------X-----XX--X---X-------------X--X----------
-------------X-----X-------------------XXX-------X-------X---X--X--------X------------------XX---------X----S----X--XX-------S----------X--------X-----X--------X--X--XX--X---X-------------X--X-X------Q-
-----E-------X-----X-------------------XXX-------X-------X---X--X--------X------------------XXX-E--X---X---------X--XX-X----------------X-------XXX----X--------X--X--XX--X---X-------------X-XX-X----S---
-------------XXXX--X-----XX------------XXXXX-----X-------X---X--X--------X------------------XXX----X---XX--------X--XX-X--------X--X----X-------XXX----X--------X--X--XX--X---X---------S---X-XX-X--------
-------------XXXX-XX--Q--XX------------XXXXX----XX-------X---X--X--------X-X----------------XXX----X--XXX--------X--XX-X--------X--X----X-------XXX----X--------X--X--XX--X---X-------------X-XX-X--X-X---
------------XXXXX-XX-----XX------------XXXXX----XX-------X---X--X--------X-X----------------XXX----X--XXX--------X--XX-X--------X--X----X-------XXX----X-E------X--X--XX--X---X-------<>----X-XXXX--X-X---
------X-----XXXXX-XX-----XX-------X----XXXXX----XX-----X-X---X--X--------X-X----------------XXX----X--XXX--------X--XX-X--------X--X----X-------XXXX---X--------X--X--XX--X---X-------[]----X-XXXX--X-X---
------X-----XXXXX-XX-----XX-------X---XXXXXX----XX-----XXX---X--X--------X-X----------------XXX--S-X--XXX--------X--XX-XX-----S-X--X----X-------XXXX---X--------X--X--XXXXX---X---XXX-[]----X-XXXX--X-X---
------X-----XXXXX-XX-----XX-------X---XXXXXX----XX----XXXX---X--X--------X-X------------E---XXX----X--XXX--------X--XX-XX-------X--X----X-------XXXX--XX--------X-XX--XXXXX---X---XXX-[]----X-XXXXX-X-X-S-
------X-----XXXXXXXX-----XX-------XX--XXXXXX----XX----XXXX---X--X--------X-X----------------XXX-E--X--XXX--------X--XX-XX----Q--X--XX---X---X---XXXX--XXX-------X-XX--XXXXX---X---XXX-[]----X-XXXXX-X-X---
---X--X--X--XXXXXXXX--<>-XX--X----XX--XXXXXX----XX----XXXX---X--X--------XXXX---------------XXX----X--XXX--------X--XX-XX-------X--XX---X---X---XXXX--XXX------XX-XX--XXXXX---X---XXX-[]----X-XXXXX-X-X-XX
---X--X--X--XXXXXXXX--[]-XX--X----XX--XXXXXX---XXX----XXXX---X--X---Q----XXXX----------S----XXX----X--XXX--------X--XX-XX----S-XX--XX---X---X---XXXX--XXX------XX-XX-XXXXXX---X---XXX-[]----XXXXXXXXXXX-XX
