----------------------------Q------------S---------E-------X-------X-------------------------------------------------------------------------------------X---------------S---------E-------------------[]-
------------X------------------------E---------------------X-------X-------E---X-------------X------S---------------------------S------------------------X-----------------------------X-------S-------[]-
--X---------XX---------------------------------------------X--X----X----X------X------------XX------------------------------------------------------X----X----------XX-----X-----------X---------------[]-
XXX--------XXXX------------------------S------------------XX--X----X----X---Q--X------------XX------------------------------------------------------X----X---Q------XX---X-X-----------X-E------------XXXX
XXX-S------XXXX-------------------------------------S-----XX--X----X----X------X-------X----XX-----X-X----------X-------------------------X---------X----X--------X-XX-X-X-X-----------X--------------XXXX
XXX--------XXXX--X-X-----------------------S--------------XX--X----X----X------X-X-----X----XX-XXX-X-X--------X-X---------X---------------X---------X----X--------X-XX-X-X-XX----------X--------------XXXX
XXX--------XXXX--X-X---------------------------------E----XX--X----X----X-----XXXXX-X--X----XX-XXX-X-X--------XXX---------X---------------X---------X----X--------X-XX-X-X-XX----------X---S-S--------XXXX
XXX--------XXXX--X-X---X--------------------------S-------XX--X----X----X-----XXXXX-X--X----XXXXXX-X-XX---E---XXX---------X------------X--X---------X----X--------X-XX-X-XXXX----------X---------E----XXXX
XXXX-------XXXX-XX-X---X----------------X-----------------XX--X----X--X-X----XXXXXX-X--X----XXXXXX-X-XX-------XXX--------XX-----XX-----X--X---------X----X--------XXXX-X-XXXX----------X--------------XXXX
XXXX-------XXXX-XX-X---X------X---------X----------S-----XXX--X----X--X-X--X-XXXXXX-XX-XX---XXXXXX-X-XX-------XXX--------XX-----XX-----X--X---------X----X--------XXXX-X-XXXX----------X--------------XXXX
XXXX---X---XXXX-XX-X---XX-?---X---------X---X---------E--XXX--X----X--X-XXXX-XXXXXX-XX-XX---XXXXXX-X-XXX------XXX--------XX-----XX-----X--X---------X----X--------XXXX-XXXXXX----------X--------------XXXX
XXXX---X---XXXX-XX-X---XX-----X-------X-X---X------------XXX--X----XXXX-XXXX-XXXXXX-XX-XX---XXXXXX-X-XXX-----XXXX-------XXX-----XX-----X--X---------X----X--X-----XXXXXXXXXXX-------X--X----X---------XXXX
XXXX---X---XXXX-XX-X---XX-----X-------X-X---X------------XXX--X----XXXX-XXXX-XXXXXXXXX-XX---XXXXXX-XXXXX-----XXXXX------XXX-----XX-----X--X---------X----X--X-----XXXXXXXXXXX-------X--X----X---------XXXX
XXXX---X---XXXXXXX-X---XX-----X---XX--X-X---X----X----X--XXX--X----XXXXXXXXX-XXXXXXXXXXXX---XXXXXX-XXXXX----XXXXXX------XXX-X---XX-----X--X---XX----X----X--X-----XXXXXXXXXXX---X---X--X----X---------XXXX
