-----------[]-----------<>-------------------------------------------------------------------S-----------------------[]--------S-------------------------------------------------X--------------S---------
-----------[]-----------[]--------------S--------------Q------------------------------------------------------X------[]---X----------X----EE-------------------------------------X---------S-----------E--
-----------[]--X--------[]----------X-------------------------X----S-----------------S---------X--------Q-S---X---X--[]---X--S-E-----X---XXXX----------------------------X----E--X------------------------
---S-------[]--X--------[]----------X---X-------------------X-X-------X-----------------X------XX-------------X---X--[]---X----------X---XXXX-----E-------------------XX-XX------X----X-------------------
-----------[]--X--------[]----------X---X-------------------X-X-------X-XX--------------X------XX-------------X---X-XXXX--X----------X---XXXX-----------------XX------XXXXX----X-X----X-------------------
XX---------[]--X----Q---[]---------XX---X-------------------X-X-------X-XX-----X-X------X------XXX---X--------X---X-XXXX--X----------X---XXXX--X------Q----S--XX------XXXXX---XX-X--Q-X----X----------X---
XX---------[]--X--------[]---------XX---X---------E---------X-X-S-----X-XX-----X-X-----XX------XXX---X--------X---X-XXXX--X----------XX--XXXX--X---------X----XX------XXXXX---XX-X----X--X-X----------X---
XXX-------XXXX-X--------[]---------XX---X-------------------XXX-------X-XX-----XXX-----XX------XXX---XX-X----XX---X-XXXX--XX---------XX--XXXX--X-------X-X----XX------XXXXX---XX-XX---XX-X-X----------X---
XXX-------XXXX-X-------XXXX--------XX---X-X---<>------------XXX-------X-XX-----XXX-----XX------XXXX--XX-X----XX---XXXXXX--XX---------XXX-XXXX--X-------XXX----XX------XXXXX---XX-XXX--XX-X-X----------X---
XXX------XXXXX-X-----X-XXXX--------XXX--X-X---[]----X-------XXX-------X-XX-----XXX-----XX------XXXX--XX-X----XX---XXXXXX--XX---------XXX-XXXX--X-------XXX----XX------XXXXX---XX-XXX--XX-X-X----------X---
XXXX-----XXXXX-X-----X-XXXX--------XXXXXX-X-X-[]----X-------XXX-------X-XX-----XXX-----XX------XXXX--XX-X----XX---XXXXXX--XX---------XXXXXXXX--X-------XXX----XX----X-XXXXX---XXXXXX--XX-X-X----------X---
XXXX----XXXXXX-X-----X-XXXX--------XXXXXX-X-XXXXXX--X-------XXX-------X-XX-----XXX-----XX------XXXX--XX-X----XX---XXXXXX--XX---------XXXXXXXX--X-------XXX----XX----X-XXXXX---XXXXXX--XX-X-X----------X---
XXXXX---XXXXXXXX-----X-XXXX--------XXXXXX-XXXXXXXXX-X--E----XXX-------X-XX-----XXX-----XX-----XXXXX--XX-X----XX---XXXXXX--XXX--------XXXXXXXX--X-------XXX----XX----X-XXXXX---XXXXXX--XX-XXX----------X--X
XXXXX---XXXXXXXXX----XXXXXX--------XXXXXXXXXXXXXXXX-X-------XXXX------XXXX-----XXX-----XX-----XXXXX--XXXX----XX---XXXXXXXXXXX--------XXXXXXXX--X-------XXX----XX----X-XXXXX---XXXXXX--XXXXXX-S--------X--X
