------------------------------------------X------------------X-------X-X----------SS-----------XX----X-----------------------Q----------X------X---------------X----------Q-------------------------------
--------------S---------------------------X------------------X-------X-X---------------------XXXX----X----------S----S------------------X------X-------------S-X-----------------------X--------------X---
------------------------------------------X-----------------XX-------X-X---------------------XXXX----X----------------------------------X------X-----E---------X-----------------------X---------X----X-X-
--------X--X-------------S----------------X----------E------XX-------X-XX-X------------------XXXX----X-------X--------------S-----------X------XX--------------X----------------------XXX--------X----X-X-
--------X--X----------------------X-------X----------------XXX-------X-XX-X---X--------------XXXX----X-------X--E-----------------------X------XX-------------XX--X-X-----------------XXX--------X----X-X-
--------X--X----------------------X-------X---------X------XXX---S---X-XX-X---X--------------XXXX----X---X---X----------S-----X---------X------XXXX-----------XX--X-X-----------------XXX--------X----X-X-
--------X--X----------E--E--------X-------X--------XX------XXX-------X-XX-X-X-X--------------XXXX----X---X---X----Q-----------X---------X------XXXX-----------XXX-X-X----E------------XXX--------XX---X-X-
--Q-----X--X----------------------X-------X--------XX------XXX-------X-XX-X-X-X---------X----XXXX----X---X---X----------------X---------X------XXXX--<>----X--XXX-X-X-----------------XXX--------XX-X-X-XX
--------X--X--X-------------------X-------X--------XX------XXX-------X-XXXX-X-X-------Q-X----XXXX----X---X---X-------------E--X-----X---X-S----XXXX--[]----X--XXX-X-X-----------------XXX--------XX-X-X-XX
--------X--X--X-------X-----------X-------X--X-----XX------XXX--X----X-XXXX-X-X---------X----XXXX----X---X-E-X----------X----XX--E--X---X------XXXX--[]---XX--XXX-X-X---------X--S----XXX-E------XX-X-X-XX
--------X--XXXX-------X-----------X-------X--X-----XX------XXX--X----XXXXXX-X-X---------X----XXXX----X---X---X----------X----XX-----X---X------XXXX--[]---XX--XXX-X-X---------X-------XXX--------XX-X-X-XX
--------X--XXXX-------X-------X---X-------X--X-X---XX------XXX--X-X--XXXXXXXX-X---------X----XXXX-X--X---X---X--------S-X----XX-----X---X------XXXX--[]---XX--XXXXX-X--------XX-------XXXX-S---X-XX-X-X-XX
--------X--XXXX-------X-------X---X-------X--X-X---XX-X-X--XXX--X-X--XXXXXXXX-X---------X----XXXX-X--X---X---X--X--X----X----XX-----X---X------XXXX--[]---XX--XXXXXXX--------XX-------XXXX-----X-XX-X-X-XX
--------X--XXXX-------X-------X---X-------X--X-X---XX-X-X--XXX--XXX--XXXXXXXXXX-----S---X----XXXXXX--X---X---X--X--X----X---XXX-----X---X------XXXX--[]---XX--XXXXXXX--------XX-------XXXX-----XXXX-X-X-XX
