---------------------X-------------X------------------X-----------E-------------X-------X-------X------X-S--------------------------S-------X--------[]---------------------------------------------------
---XX----------------X----------E--X----------X----X--X-------------------------X-------X-------X--S---X------------------X------E----------X--------[]-----------------------------------------XX--------
---XX----------------X-----X-------X-----X----X----X--X--------------S----------X-------X-------X------X----------------S-X-----------------X--------[]-----------------------------------------XX-X------
---XX----------------X----XX-------X-----X----X----X--X-------------------------X--XX-X-X-------X------X------------------X-S---------------XX------XXXX---------------------------------------XXX-X------
---XX----------------X----XX--<>-X-X-----XX---XX---X--X-X----------X------------X--XX-X-X-------X------X-------------X----X------X----------XX-S----XXXX----S----------------------------------XXX-X--X---
---XX----X-XX--------X----XX--[]-XXX-----XX---XX---X--X-X----------X------------X--XX-X-X-------X-----XX----S--------X----X-S----X------X---XX-----XXXXX-----------------S----XX----SS---------XXXXX--X---
---XX-X--X-XX--------X----XX--[]-XXX-----XX---XX---X--X-X---E------X--------X---X--XX-XXX---E---X-----XX-------------X----X------X----S-X-X-XX-----XXXXX----------------------XX---------------XXXXX--X---
---XX-X--X-XX--------X----XX--[]-XXX-----XX---XX---X--X-X------X---X-----E--X---XX-XX-XXX--XXX--X-----XX----X----X---X----X------X------X-X-XX-----XXXXX----------------------XX---------------XXXXX--X---
---XX-X--X-XX--------X----XX--[]-XXX---S-XX---XXX--X--X-X------X---X--------X---XX-XX-XXX--XXXX-X-----XX----X----X---X----X------X------X-X-XX-----XXXXX----------------------XX---------------XXXXX--X---
---XX-X--X-XX--------X----XX--[]-XXXX----XX---XXX--X--X-X------X---X-------XX---XX-XX-XXX-XXXXX-X-----XX----X--Q-X---X----X------X------X-X-XX-----XXXXX-----------XX---------XX------------X--XXXXX--X---
---XX-X--X-XX------X-X----XX--[]-XXXX----XX---XXX--X--X-X------X--XX-------XX---XX-XX-XXXXXXXXX-X-----XX----XX---X---X----XX-----X------X-X-XX-----XXXXXXX---------XX-----S---XX------------X-XXXXXX--XX--
---XX-X--XXXX------X-X-X--XX--[]-XXXXX---XX---XXX--X--X-X------X--XX-Q--X--XX---XX-XX-XXXXXXXXX-X-X---XXX---XX---X---X---XXX-----X------X-X-XX-----XXXXXXX---X-----XX---------XX------------X-XXXXXX--XX--
-E-XXXX--XXXX------X-XXXXXXX--[]-XXXXX---XX--XXXX--X--X-X------X--XX----X--XX--XXXXXXXXXXXXXXXX-X-X---XXX---XX---X---X---XXX-----X------XXX-XX-----XXXXXXX---X-----XXX----X---XX------------X-XXXXXX--XX--
---XXXX--XXXX------X-XXXXXXX--[]-XXXXX---XX--XXXXX-X--X-X------X--XX----X--XX--XXXXXXXXXXXXXXXX-XXX---XXX---XX---X---X---XXX-----X------XXXXXX-----XXXXXXX---X-----XXX----X---XXX----------XX-XXXXXX--XX--
