--X-------S------------------X--------------------------------------------------------------------------------------------X-----------------S---X----------------------------S-------------------S--------
--X----------X---------------X---------------------------------S-------------------X--------------------------------------X-----<>--------------XX-----S----------------------------E---------------------
--X-------X--X----------E----X----------Q------X------------X------------------S---XX------------------------X------------X---X-[]--------------XX-E-------------------------------------------S----------
--X-------X--X---------------XX----------------X------------X-----------X----------XXX--------------------S--X--X---------X---X-[]--------------XX--------------------------------------S-----------------
--X-------X--X---------------XX---------X-----XX------------X--------<>-X----------XXX---X-----------X------XX--X---------X---XXXXX-------------XX---------------------------------X-----------X----------
--X-------XXXX--S---Q--------XX---------X-----XX------------X--------[]-X----------XXX---X-----------X------XX--X---------X---XXXXX-----X-------XX----------------------X----------X-----------X----------
--X-------XXXX------------X--XX----X----X---S-XX--------S---XX---X---[]-X----------XXX---X-----------XX-----XX--X----X----XX--XXXXX-----X-------XX----------------------X----------X-----------X----------
--X-------XXXX------------X--XX----X----X-----XX------------XX---X---[]-X----------XXX---X-----------XX-----XX--X----X----XX--XXXXX----XX-X-----XX-------------X--------X----------X-XX--------X----------
--X-------XXXX------------X--XX----XX---X-----XX------------XX---X--XXXXX-XX------XXXX---X----------XXX-----XX--X----X----XX--XXXXX---XXX-X-----XX-------------X--------X----------X-XX--------X----------
--X--X----XXXXX---S-------X--XX---XXX---X-----XX------------XX---X--XXXXX-XX---E--XXXX---XX---S-----XXX-----XX--X----X----XX--XXXXX---XXX-X----XXX-------------X--------X----------X-XX------E-X--------XX
--X--XX---XXXXX--------X--X--XX---XXX---X-----XX------------XX---X--XXXXX-XXX-----XXXX-S-XX---------XXXX----XX--X----X--S-XXX-XXXXX---XXX-X----XXX-------------X--------X----X-----X-XX--------X-X------XX
--X--XX---XXXXX----S--XX--X--XX---XXX---X-----XX----------Q-XX---X--XXXXX-XXX-----XXXX---XX-X-------XXXX----XX--X----X----XXX-XXXXX---XXX-X----XXX-------------X--------X----X-----X-XXX------XX-X------XX
--X--XX-X-XXXXX-------XXXXX--XX---XXX---X-----XX------------XX---X-XXXXXX-XXX-----XXXX---XX-X---X---XXXX----XX--X----XX---XXX-XXXXX---XXX-X----XXX-------X-----X--------X----X-----X-XXX-----XXX-X------XX
--X--XXXX-XXXXX-X-----XXXXX--XXX--XXX---X-----XX------------XX-XXXXXXXXXX-XXX-----XXXX---XXXX---X---XXXX----XX--X----XX-E-XXX-XXXXX---XXX-X----XXXX------X--X--X-----S--X----X-----X-XXX-----XXX-X------XX
