----?-------------------------<>-------------------------X-X----------------------------------------------X-----X-------------------------X-------------------------------------X---------------Q---------
----------S-------------------[]-------------------------X-X---------------------X------------------------X-----X----------------------X--X-----X--X---------------------------XX-X----------------E------
------------------------------[]-------------------S-X--XX-X----------------X----X------------------------X-----X----------------------X--X-----X--X-X-------------------------XX-X------X----------------
---S--------------------------[]------E--------------X--XX-X----------------X----X--------Q------X--------X-----X--X------X--X---------X--X-----X--X-X-------------X-----------XX-X------X-----S----X--X--
-----------------------E-----XXXX----------XX-----X--X--XX-X---------------XX----X-<>------------X--------X-----X--X------X--X---------X--X-----X--X-X-------------X---------E-XX-X------X----------X--X--
----X---X--------------------XXXX----S-E---XX-----X--X--XX-X---------------XX----X-[]------------X--------X-----X--X------X-XX---------X--X-----X--X-X-------------X-X---------XX-X-----XXX---------X--X--
XX-XX-X-X-------E-----S----X-XXXX----------XX---X-X--X--XX-XX-------X------XX----X-[]-----------XX--------X----XX--X------X-XX---------XX-XX-X--X--X-X-------------X-X---------XX-X--E-XXXX------X--X--X--
XXXXX-X-X----<>------------X-XXXX----------XX---X-X--X--XX-XX-------X------XX-X--X-[]--X---S----XX--------X----XX--X------X-XX---X-----XX-XX-X--X--X-X-------------X-X---------XX-X----XXXX------X--X--X--
XXXXX-X-X----[]------------X-XXXX----------XX-S-XXX--X--XX-XX-------X------XX-X--X-[]--X-------XXX--------X--X-XX--X------X-XX---X-----XXXXX-X--X--X-XX-----X------X-X---------XX-X----XXXX------X--X--X--
XXXXX-X-X----[]------------X-XXXX-E----X---XX---XXX--X--XX-XX-------X------XX-X--X-[]--X------XXXX--------X--X-XXXXX------X-XX---X-----XXXXX-X--X--X-XX-----XXX-X--X-X-------Q-XX-X----XXXX------XXXX--X--
XXXXX-X-X----[]------------X-XXXX------X---XX---XXX--X--XX-XX-----E-X------XX-X--X-[]--XX-----XXXX--------X--X-XXXXX-S----X-XX---X-----XXXXX-X--X--X-XXX----XXX-X--X-X---------XX-X----XXXX------XXXX--X--
XXXXX-X-X----[]------------X-XXXX------X---XX---XXX--X--XX-XX-------X----X-XX-X--X-[]--XX-----XXXX--------X--X-XXXXX------X-XX---X-----XXXXX-X--X--X-XXX----XXX-X--XXX-------X-XX-X----XXXX------XXXX--X--
XXXXX-XXX---XXXX-----------X-XXXX---X--X---XXX--XXX--X--XX-XX-------X----X-XX-X--X-[]--XX-----XXXX--------X--XXXXXXX-----XX-XX---X-----XXXXX-X--X--XXXXX----XXX-X--XXX-------X-XX-X----XXXX-X----XXXX-XX--
XXXXX-XXX---XXXX-<>--------X-XXXX-X-X--X---XXX--XXX--X--XX-XX-------X----X-XXXX--X-[]--XX-----XXXX--------X--XXXXXXX----XXX-XX---X-----XXXXX-X--X--XXXXX----XXXXX--XXX-------X-XX-X----XXXXXX----XXXX-XXXX
