---------------------------<>-------------------------S---X----------X------[]-------------------------------------------S--------------------------------------E----------XX--X-------------------X-X----
---------------------------[]-----------------------------X----------X------[]-------<>------------------------------------------------------------------------------------XX--X-------------------X-X----
---------------------X-----[]--Q-------------?-X--X----S--X----------X------[]--X----[]----------------------X---------------------------------------------------?---------XX--X-------------------X-XX---
---------------------X----XXXX------X-----X----X--X-------X----------X---S-XXXXXX----[]----------------------X-----------X----X-------------X------X-----------------------XX--X-----X----XX-------X-XX---
---------------------X---XXXXX------X-----X----X--X-------X----------X-----XXXXXX---XXXX---------------------X-----------X----X-------------XX-E-X-X----S------X-----------XX--X-----X----XX-------X-XX---
---------------------X---XXXXX------X-----X----X--XX------X----------X-----XXXXXX---XXXX------------S--------X-----------X----X---X---------XX---X-X-----------X-----------XX--X-----X----XX-------X-XXX-E
----------------<>---X---XXXXX-S--X-XX----XX---XX-XX------X----------X-----XXXXXX---XXXX----E---------------XX-----------X----X---X--------XXX-X-X-X-----------X-----------XX--X-----X----XX-------X-XXX--
--------X-------[]---X---XXXXX----X-XX----XX---XX-XX------X----------X-----XXXXXX---XXXX-------------------XXX-----------X-X--X---X--------XXXXX-X-X--E--------X-----------XX--X-----X----XX-E-----X-XXX--
--------X-------[]---X---XXXXX----X-XX----XX---XX-XX------X----------X-----XXXXXX--XXXXX----------X--E-----XXX-----------X-X--XX--X--------XXXXXXX-X--------X--X-----------XX--X-----XX---XX-------X-XXX--
----X---X----E--[]---X---XXXXX----X-XX----XX---XX-XX--X---X----------X----XXXXXXX--XXXXX----------X-----X--XXX-----------X-X--XX-XX----X---XXXXXXX-X-----X--X--X-----------XX--X-----XX---XX-------X-XXX--
----X---X-------[]---X---XXXXX----X-XX----XX---XX-XX--X---X----------X--X-XXXXXXX--XXXXX-------EE-X-----X--XXX--X--------X-X--XX-XXX---X---XXXXXXX-X-----X--X--X-------X--XXX--X-----XX-Q-XX---S---X-XXX--
----XX-XX-------[]---X---XXXXX----X-XX----XX-XXXX-XX--X---X----------X--X-XXXXXXX--XXXXX------XXXXX-----X--XXX--X---XX---X-X--XX-XXX---X-S-XXXXXXX-X-----X--X--X-------X--XXX-XX--XXXXX---XXX------X-XXX--
----XX-XX-------[]--XX---XXXXX----X-XX----XX-XXXX-XX--X---X-----X----X--X-XXXXXXXX-XXXXX------XXXXX-----X--XXX--X---XX---X-X--XX-XXX---X---XXXXXXX-X-----X--X--X---S---X--XXX-XX--XXXXX---XXX------X-XXX--
--X-XX-XX------XXXXXXX---XXXXX----XXXX---XXX-XXXX-XX--X---X-----X----X--X-XXXXXXXX-XXXXX------XXXXX-----X--XXX--X---XX---XXX--XX-XXX---X---XXXXXXXXX-----X--X--X-----XXX--XXX-XXXXXXXXX---XXX------X-XXX--
