---X---------S--Q-----------------------S--------------------S-----------E--------------------------X-----------X-------------X-E-----------------?--------------------<>---------------------------------
---X------------------------------Q--X----X---------------------------------------------------------X---X-------X-------------X-----------------S----------------------[]--------------X----S-------------
E-XX--------------<>-----------------X----X---------------------------X----------XX-----------------X---X-------X-----------X-X----------------------------------------[]--------------X------------------
--XXX-------------[]-----------------X----X---X-----------------------X----------XX------------<>--XX---X-------X-----------X-X----------------X----------------X-X---XXXX-------------X----------X--X----
-XXXX-------------[]------E----------X----X---X-----------------------X------E---XX---X--------[]--XX---X-------X----<>-----X-X--X-------------X----------------XXX---XXXXX--Q---------X----------XX-X----
XXXXX-----------S-[]--E--------------X----XX--X-----------------------X----------XX---X-------XXXX-XXX--X------XX----[]-----X-X--X-------------X----------------XXX---XXXXX------------X---X------XX-X----
XXXXX-------------[]-----------------X----XX--X---X-------------------X------X---XX---X-------XXXX-XXX--X-----XXX----[]-----X-X--X-------------X--------------S-XXX---XXXXX------X-----X---X------XX-X----
XXXXX------------XXXX----------------X----XXX-X---X---S---------------XX-----X---XX---X------XXXXX-XXX--X-----XXX----[]-----X-X--X-X--X---X----X----------------XXX---XXXXX------X-----XX--X------XX-X----
XXXXX------------XXXX--------X----S--X----XXX-X---X-----X------------XXX-S---X---XX--XX------XXXXX-XXX--X-----XXX---XXXX----XXX--X-X--X---X----X------------X---XXX---XXXXX------X-----XX--X---X--XX-X----
XXXXX------------XXXX--X-----X-------X----XXX-X---X-S---X--X---------XXX-----X---XX--XX------XXXXXXXXX-XX-----XXX---XXXX----XXX--X-X--X---X----X-------S----X---XXX---XXXXX-<>---X-----XX--X---X--XX-X--SQ
XXXXX--------E---XXXX--X-----X-------X-S--XXX-X---X-----X--X-------X-XXX-----X---XX--XX-----XXXXXXXXXXXXX-----XXX---XXXX---XXXX--X-X--X---X----XX----X------X---XXX-E-XXXXX-[]---X-----XX--X---X--XX-X----
XXXXX---X--X-----XXXX--X-----X-------X----XXX-X---X-----X--X-------X-XXX-----X---XX--XXX--X-XXXXXXXXXXXXX-----XXX---XXXX---XXXX--XXX--X---X----XX----X------X---XXX---XXXXX-[]---X-----XX--X---X--XX-X--X-
XXXXX---X--XX-Q--XXXX--X-----X-------X----XXX-X-Q-X-----X--X-------XXXXX--X--X---XX--XXX--X-XXXXXXXXXXXXX-----XXX---XXXXX--XXXX--XXX--X---X----XX----X------X---XXX---XXXXX-[]---X-----XX--X-S-X--XX-X--X-
XXXXX---X--XX----XXXX--X-----X--X----X----XXXXX---X--X-XX--X-------XXXXX--X--X---XX--XXX--XXXXXXXXXXXXXXX-----XXX---XXXXX--XXXX--XXX--X---X----XX----X------X---XXX---XXXXX-[]---X-----XX--X---X--XX-X--X-
