------------------------------------------------------------------------------------------------------
------------------------------------------------------------------------------------------------------
---------------xxx----xxxx----------------------------------------------------------------------------
--------------xx--x--xx---x----------------------------------------------------------------------xxx--
-------------xx----xxx-----xxxxx-------------------------------------------------------xxxx----xxx----
------------xxX----xx-------x---x---------------------QQQ---E-E-E------------S--------xx---x--xxXS----
-----------xxXX-----X------XX----x-------------------------<><><>--------------------xx-----xxxEX-----
---xx-----xxXXXXX-----------------x------------------------[][][]-------------------xx-------xXXX-----
--xx-x---xxXXXX--------------------xxxxx-------------------QQQQQQ--------------xxxxxx--------XXXXS----
-xx---x-xxXXXXX---------------------xXX-xSSS-----------------------------XQ--xxx---<>-------XXXXX-----
xx-----xxXXXXXX---------------------XXX--x--------X------------------xxxx---xx<>---[]------XXXXXX-----
x------XXXXXXXX-E------------------XXXX---x-------X-----xx----------xx---x-xx-[]---[]-----XXXXXXX-----
X------XXXXXXXX<>-----------------XXXXX----xxxxxxxxxxxxxx-Exxxxxxxxxx-----xx--[]---[]----XXXXXXXX-----
X------XXXXXXXX[]-----------------XXXXXXXXXXXX-----------XXXXXXXXXXX---------XXXXX-XXXXXXXXXXXXXXXXXXX
XXXXXXXXXXXXXXXXX----------------XXXXXXXXXXXXXX-----------XXXXXXXXXXX--------XXXXXXXXXXXXXXXXXXXXXXXXX
XXXXXXXXXXXXXXXXXXXXXX-----------XXXXXXXXXXXXXXXXXX-----------XXXXXXX--------XXXXXXXXXXXXXXXXXXXXXXXXX
