--------------------------------------------------------------------------------------------------------------------------------------------------------------------------------------------------
--------------------------------------------------------------------------------------------------------------------------------------------------------------------------------------------------
--------------------------------------------------------------------------------------------------------------------------------------------------------------------------------------------------
--------------------------------------------------------------------------------------------------------------------------------------------------------------------------------------------------
--------------------------------------------------------------------------------------------------------------------------------------------------------------------------------------------------
------------------------------------------------------------------------------E-------------------------------------------------------------------------------------------------------------------
------------------S---------------------------------------------------------SSSSSSSS---SSSS--------------Q-----------SSS----SSSS--------------------------------------------------------XX--------
---------------------------------------------------------------------------------------------------------------------------------------------------------------------------------------XXX--------
---------------------------------------------------------------------------E----------------------------------------------------------------------------------------------------------XXXX--------
------------------------------------------------------------ooo----------------------------------------------------------------------------------------------------------------------XXXXX--------
------------S---SQSSS---------------------<>---------<>------------------SQS--------------Q-----SQ----S--S--S-----S----------SS------X--X----------XX--X------------SSSS------------XXXXXX--------
----------------------------------<>------[]---------[]-----------------------------------------------------------------------------XX--XX--------XXX--XX--------------------------XXXXXXX--------
------------------------<>--------[]------[]---------[]----------------------------------------------------------------------------XXX--XXX------XXXX--XXX-----<>--------------<>-XXXXXXXX--------
-----------------E------[]--------[]-E----[]-----E-E-[]------------------------------------E-E--------E-----------------EE-E-E----XXXX--XXXX----XXXXX--XXXX----[]---------EE---[]XXXXXXXXX--------
XXXXXXXXXXXXXXXXXXXXXXXXXXXXXXXXXXXXXXXXXXXXXXXXXXXXXXXXXXXXXXXXX--XXXXXXXXXXXXXXX---XXXXXXXXXXXXXXXXXXXXXXXXXXXXXXXXXXXXXXXXXXXXXXXXXXXXXXXXXXXXXXXX--XXXXXXXXXXXXXXXXXXXXXXXXXXXXXXXXXXXXXXXXXXX
XXXXXXXXXXXXXXXXXXXXXXXXXXXXXXXXXXXXXXXXXXXXXXXXXXXXXXXXXXXXXXXXX--XXXXXXXXXXXXXXX---XXXXXXXXXXXXXXXXXXXXXXXXXXXXXXXXXXXXXXXXXXXXXXXXXXXXXXXXXXXXXXXX--XXXXXXXXXXXXXXXXXXXXXXXXXXXXXXXXXXXXXXXXXXX
