----------------------------------------------------------------------------------------------------------------------------------------------------
----------------------------------------------------------------------------------------------------------------------------------------------------
----------------------------------------------------------------------------------------------------------------------------------------------------
----------------------------------------------------------------------------------------------------------------------------------------------------
----------------------------------------------------------------------------------------------------------------------------------------------------
----------------------------------------------------------------------------------------------------------------------------------------------------
----------------------------------------------------------------------------------------------------------------------------------------------------
----------------------------------------------------------------------------------------------------------------------------------------------------
----------------------------------------------------------------------------------------------------------------------------------------------------
----------------------------------------------------------------------------------------------------------------------------------------------------
---------------------------------------------------------------------------------------------------------------------------------tt-----------------
-----------------------------------r-----------------------------------------------------------------------------------#---#-----tt---tt------------
%%%%%%%%%%---#--#----------------%%%%%--------#--#------------%%%%%%%%%%---%%%%%%---%%%%------------------------------##---##----tt---tt------------
||||||||||--##--##-----#---#-----|||||------%%%--%%%%%--------||||||||||---||||||---||||%%%---%%%%%%---%%%-----------###---###--%%%%%%%%%%%%%%%%%%F%
||||||||||%%%%--%%%%--##---##----|||||---%%%|||--|||||%%%--%%%||||||||||---||||||---|||||||---||||||---|||%%%---%%%%%%%%---%%%%%||||||||||||||||||%|
||||||||||||||--||||XXXX---XXXXXXXXXXXXXX||||||--||||||||--|||||||||||||---||||||---|||||||---||||||---||||||---||||||||---|||||||||||||||||||||||||