------------------------------------XXXX-------------------------------------XXXXX------------X-------
-------------------------------------XX-------------------------------------XXXXXX------------X-------
-------------------------------------XX------------------------------------XXXXXXX------------X-------
-------------------------------------------------------------QQQ----------XXXXXXXX------------X-------
----------------------------------------------------------------E-----------------------------X-------
-----------------------------------XXXXX------------------------------------------------------X-------
----------------------------------XXXXXX---------------------------------XXXXXXXXXX-----------X-------
---------------------------------XXXXXXX-------------------------XX------XXXXXXXXXX----------X--------
--------------------------------XXXXXXXX---------------------XXXX--------XXXXXXXXX----------X---------
---------------QQQ-------------XXXXXXXXX----------E---------XXXX--------XXXXXXXXXX--------------------
------------------------------XXXXXXXXXX---------<><>------XXXX--------XXXXXXXXXXX-----------E--------
-----------------------------XXXXXXXXXXX-EE------[][]------XXXX-------XXXXXXXXXXXX---------XXX--------
------------XXXX------------XXXXXXXXXXXXXXXX-----XXXXX-----XXXX------XXXXXXXXXXXXX--------------------
---------------------------XXXXXXXXXXXXXXXXXX-------------XXXXX------XXXXXXXXXXXXX--------------------
XXXXXXX--------------------XXXXXXXXXXXXXXXXXXX-----------XXXXXX------XXXXXXXXXXXXX--------------------
XXXXXXX--------------------XXXXXXXXXXXXXXXXXXX-----------XXXXXX------XXXXXXXXXXXXX-------------------X