--------------------------------------------------------------------------------------------------------------------------------------------------------------
--------------------------------------------------------------------------------------------------------------------------------------------------------------
--------------------------------------------------------------------------------------------------------------------------------------------------------------
S-----SSSSSSSSSSSSSSSSSSSSSSSSSSSSSSSSSSSSSSSSSSSSSSSSSSSSSSSSSSSSSSSSSSSSSSSSSSSSSSSSSSSLSSSSSSSSSSSSSSSSSSSSSSSSSSSSSSSSSSSSSSSSSSSSSSSS--------------------
S-----------------------------------------------------SS--SSSSSS--SSSS------SSSS------------------------------------------------------------------------------
S-----------------------------------------------------SS--SSSSSS--SSSS---E--SSSS------------------------------------------------------------------------------
S----------------------------------------oooo-------SS--------SS---S----SS----------oooooo--------------------------------------------------SSS---------------
S---------------------------------------------------SS--------SS---S----SS------------------------------------------------------------------------------------
S--------------------------------------S-SSSS-U-----SS--------SS---S----SS----------SSSSSS--------------------------------------------------------------------
S----------------------------?---------SoS--SoS-----SS----ooooSS---SoU--S?--E-E-----SSSSSS-------------------------------------------------------SSSSSSU------
S---------QQQQQ--------X-X-------------SSS--SSS-----SSSS--SSSSSS---SSS--SS--SSSS-----------------------------<>------------------------EXX--------------------
---------------------X-X-X-X---X----------------------SS-----------------------------------------------<>----[]-----------SS-----------XXX--------------------
-----------------E-X-X-X-X-X---X-X--------------------SS-----------------------------------------------[]----[]----<>-----SS---------EXXXX--SSS---------------
----------------EX-X-X-X-X-X-E-X-X--------EE----------------E--E-E------------------------------E-E-E--[]----[]--E-[]-----SS---------XXXXX---------E----------
XXXXXXXXXXXXXXXXXXXXXXXXXXXXXXXXXXXXXXXXXXXXXXXXXXXXX----XXXXXXXXXXXXXXXXXXXXXXX---XXXXXXXXXXXXXXXXXXXXXXXXXXXXXXXXXXXXX--XX--XXXXXXXXXXXX-------XXXXXXXX--XXX
XXXXXXXXXXXXXXXXXXXXXXXXXXXXXXXXXXXXXXXXXXXXXXXXXXXXXXXXXXXXXXXXXXXXXXXXXXXXXXXX---XXXXXXXXXXXXXXXXXXXXXXXXXXXXXXXXXXXXX--XX--XXXXXXXXXXXX-------XXXXXXXX--XXX
