----------------------------------------------------------------------------------------------------------------------------------------------------
----------------------------------------------------------------------------------------------------------------------------------------------------
----------------------------------------------------------------------------------------------------------------------------------------------------
----------------------------------------------------------------------------------------------------------------------------------------------------
----------------------------------------------------------------------------------------------------------------------------------------------------
----------------------------------------------------------------------------------------------------------------------------------------------------
----------------------------------------------------------------------------------------------------------------------------------------------------
----------------------------------------------------------------------------------------------------------------------------------------------------
----------------------------------------------------------------------------------------------------------------------------------------------------
--------------QQ-----------------------------------------------------XXX----------------------------------------------------------E-----------------
---------------------------------------------------------------------XXX---------------------------------------------------------<>----E------------
-----------------------------------E------------------------------E--XXX-----------------------------------------------X---X-----[]---<>------------
-------------X--X----------------XXXXX--------X--X------------XXXXXXXXXX------------XXXX------------------------------XX---XX----[]---[]--------F---
------------XX--XX-----X---X-----XXXXX------XXX--XXXXX--------XXXXXXXXXX------------XXXXXXX---XXXXXX---XXX-----------XXX---XXX--XXXXXXXXXXXXXXXXXXXX
XXXXXXXXXXXXXX--XXXX--XX---XX----XXXXX---XXXXXX--XXXXXXXX--XXXXXXXXXXXXX------------XXXXXXX---XXXXXX---XXXXXX---XXXXXXXX---XXXXXXXXXXXXXXXXXXXXXXXXX
XXXXXXXXXXXXXX--XXXXXXXX---XXXXXXXXXXXXXXXXXXXX--XXXXXXXX--XXXXXXXXXXXXX------------XXXXXXX---XXXXXX---XXXXXX---XXXXXXXX---XXXXXXXXXXXXXXXXXXXXXXXXX
